########################
#......................#
#.....#.......C........#
###.......###..........#
#....P..............F..#
########################
