########################
#..C....###.........C..#
#..###....#..###.......#
#..P.............C..F..#
#......###....###......#
########################
